        level = [
            "PPPPPPPPPPPPPPPPPPPPPPPPPPPPPPPPPPPPPPPPPPPP",
            "P                                          P",
            "P                                          P",
            "P                                          P",
            "PPPPPPPPPP                                 P",
            "PPPPPPPPPPP                                P",
            "PPPPPPPPPPPP                               P",
            "PPPPPPPPPPPPP                              P",
            "PPPPPPPPPPPPPP                             P",
            "PPPPPPPPPPPPPPP                            P",
            "PPPPPPPPPPPPPPPP                           P",
            "PPPPPPPPPPPPPPPPP                          P",
            "PPPPPPPPPPPPPPPPPP                         P",
            "PPPPPPPPPPPPPPPPPPP                        P",
            "PPPPPPPPPPPPPPPPPPPP                       P",
            "PPPPPPPPPPPPPPPPPPPPP                      P",
            "PPPPPPPPPPPPPPPPPPPPPP                     P",
            "PPPPPPPPPPPPPPPPPPPPPPP                    P",
            "PPPPPPPPPPPPPPPPPPPPPPPP                   P",
            "PPPPPPPPPPPPPPPPPPPPPPPPP                  P",
            "PPPPPPPPPPPPPPPPPPPPPPPPPP                 P",
            "PPPPPPPPPPPPPPPPPPPPPPPPPPP                P",
            "PPPPPPPPPPPPPPPPPPPPPPPPPPPP              EP",
            "PPPPPPPPPPPPPPPPPPPPPPPPPPPPP             EP",
            "FFFFFFFFFFFFFFFFFFFFFFFFFFFFFFFFFFFFFFFFFFFF"]
